NO ./assets/textures/julia_fourth_x8192.xpm
SO ./assets/textures/newton_x8192.xpm
WE ./assets/textures/reverse_mandelbrot_x8192.xpm
EA ./assets/textures/julia_third_x8192.xpm

F 0, 0, 0
C 4, 170, 182

                                       1111
                                      100001
                                     10000001
                                      100001
                         111     11111110011111111
                         1001111100000000000000000111  11
                          11000000000000000000000000011001
                         11000000000000000000000000000111
                        10000000000000000000000000000001
                       1000000000000000000000000000000001
            11        10000000000000000000000000000000001
        1111001111   1000000000000000000000000000000000001
       100000000001  1000000000000000000000000000000000001
      10000000000001 100000000000000000000000000000000001
   1 1000000000000001000000000000000000000000000000000001
 1101000000000000000100000000000000000000000000000000001
100000000000E0000000D0000000000000000000000000000000011
 1101000000000000000100000000000000000000000000000000001
   1 1000000000000001000000000000000000000000000000000001
      10000000000001 100000000000000000000000000000000001
       100000000001  1000000000000000000000000000000000001
        1111001111   1000000000000000000000000000000000001
            11        10000000000000000000000000000000001
                       1000000000000000000000000000000001
                        10000000000000000000000000000001
                         11000000000000000000000000000111
                          10000000000000000000000000011001
                         1011111100000000000000000111  11
                         111     11111110011111111
                                      100001
                                     10000001
                                      100001
                                       1111