NO ./assets/textures/fractol_x8192.xpm
SO ./assets/textures/fractol_x8192.xpm
WE ./assets/textures/fractol_x8192.xpm
EA ./assets/textures/fractol_x8192.xpm

F 0, 0, 0
C 4, 170, 182

111111111111111111111111111111111111111111111111
100000000000000000000000000000000000000000000001
100000000000000000111111111000000000000000000001
100000000000000000D000N000D000000000000000000001
100000000000000000111111111000000000000000000001
100000000000000000000000000000000000000000000001
111111111111111111111111111111111111111111111111