NO ./assets/textures/North.xpm
SO ./assets/textures/South.xpm
WE ./assets/textures/West.xpm
EA ./assets/textures/East.xpm
F 220, 100, 12
C 225, 30, 87

        1111111111111111111111111
        1000000000110000000000001
        1011000001110000000000001
        1001000000000000000000001
111111111011000001110000000000001
100000000011000001110111111111111
111101111111110111000000100011
111101111111110111010100000000000000001
110000001101010111000000100011111111111
11000000000000001100000010001
10000000000000001101010010001
11000001 10101011111011110N0111
11110111 1110101 101111010001
11111111 1111111 111111111111
