NO assets/textures/877.xpm
SO assets/textures/877.xpm
WE assets/textures/877.xpm
EA assets/textures/877.xpm

F 85,55,29
C 119,181,254

        1111111111111111111111111
        1000000000110000000000001
        1011000001110000000000001
        1001E00000000000000000001
111111111011000001110000000000001
100000000011000001110111110111111
11110111111111011100000010001
11110111111111011101010010001
11000000110101011100000010001
10000000001000001100000010001
10000000000100001101010010001
110000011101010111110111100111
11110111 1110101 101111010001
11111111 1111111 11111111111